10.ox
.....o....
........oo
..........
......o...
...oo.....
..o.......
.o..o.....
..........
........oo
o........o
